XXXXXXXXXXXXXXXXXXXXXXXXXXXXXXXX
BBBBBBBBBBBBBBBBBBBBBBBBBBBBBBBB
AAAAAAAAAAAAAAAAAAAAAAAAAAAAAAAA
FFFFFFFFFFFFFFHAKFFFFFFFFFFFFFFF
XXXXXXXXXXXXX8JAE8XXXXXXXXXXXXXX
XXXXXXXXXXXXX8JAE8XXXXXXXXXXXXXX
XXXXXXXXXXXXX8JAE8XXXXXXXXXXXXXX
XXXXXXXXXXXXX8JAE8XXXXXXXXXXXXXX
XXXXXXXXXXXXX8JAE8XXXXXXXXXXXXXX
XXXXXXXXXXXXX8JAE8XXXXXXXXXXXXXX
XXXXXXXXXXXXX8JAE8XXXXXXXXXXXXXX
XXXXXXXXXXXXX8JAE8XXXXXXXXXXXXXX
XXXXXXXXXXXXX8JAE8XXXXXXXXXXXXXX
XXXXXXXXXXXXX8JAE8XXXXXXXXXXXXXX
XXXXXXXXXXXXX8JAE8XXXXXXXXXXXXXX
XXXXXXXXXXXXX8JAE8XXXXXXXXXXXXXX
XXXXXXXXXXXXX8JAE8XXXXXXXXXXXXXX
XXXXXXXXXXXXX8JAE8XXXXXXXXXXXXXX
XXXXXXXXXXXXX8JAE8XXXXXXXXXXXXXX
XXXXXXXXXXXXX8JAE8XXXXXXXXXXXXXX
XXXXXXXXXXXXX8JAE8XXXXXXXXXXXXXX
XXXXXXXXXXXXX8JAE8XXXXXXXXXXXXXX
XXXXXXXXXXXXX8JAE8XXXXXXXXXXXXXX
XXXXXXXXXXXXX8JAE8XXXXXXXXXXXXXX