BBBBBBBBBBBBBBBBBBBBBBBBBBBBBBBB
AAAAAAAAAAAAAAAAAAAAAAAAAAAAAAAA
FFFFFFFFFFFFFFHAKFFFFFFFFFFFFFFF
12333333333335JAE6XXXXXXXXXXXXXX
XXXXXXXXXXXXX9JAE8XXXXXXXXXXXXXX
XXXXXXXXXXXXX8JAE8XXXXXXXXXXXXXX
XXXXXXXX233334JAE8XXXXXXXXXXXXXX
XXXXXXXXBBBBBBCAE8XXXXXXXXXXXXXX
XXXXXXXXAAAAAAAAE8XXXXXXXXXXXXXX
XXXXXXXXFFFFFFHAE8XXXXXXXXXXXXXX
XXXXXXXX233335JAE8XXXXXXXXXXXXXX
XXXXXXXXXXXXX8JAE8XXXXXXXXXXXXXX
XXXXXXXXXXXXX8JAE8XXXXXXXXXXXXXX
XXXXXXX1233334JAE8XXXXXXXXXXXXXX
XXXXXXXXXXXXXXJAE8XXXXXXXXXXXXXX
XXXXXXXXXXXXXXJAE8XXXXXXXXXXXXXX
XXXXXXXXXXXXXXJAE8XXXXXXXXXXXXXX
XXXXXXXXXXXXXXJAE8XXXXXXXXXXXXXX
XXXXXXXXXXXXXXJAE8XXXXXXXXXXXXXX
X3333333333335JAE8XXXXXXXXXXXXXX
XXXXXXXXXXXXX8JAE8XXXXXXXXXXXXXX
XXXXXXXXXXXXX8JAE8XXXXXXXXXXXXXX
XXXXXXXXXXXXX8JAE8XXXXXXXXXXXXXX
XXXXXXX1233334JAE0XXXXXXXXXXXXXX
