XXXXXXXXXXXXXXXXXXXXXXXXXXXXXXXX
BBBBBBBBBBBBBBBBBBBBBBBBBBBBBBBB
AAAAAAAAAAAAAAAAAAAAAAAAAAAAAAAA
FFFFFFFFFFFFFFHAKFFFFFFFFFFFFFFF
12333333333335JAEN333337XXXXXXXX
XXXXXXXXXXXXX9JAE8XXXXXXXXXXXXXX
XXXXXXXXXXXXX8JAE8XXXXXXXXXXXXXX
XXXXXXXX233334JAE8XXXXXXXXXXXXXX
BBBBBBBBBBBBBBCAE0XXXXXXXXXXXXXX
AAAAAAAAAAAAAAAAEXXXXXXXXXXXXXXX
FFFHAKFFFFFFFFHAEXXXXXXXXXXXXXXX
XXXJAE33333335JAEXXXXXXXXXXXXXXX
XXXJAEXXXXXXX8JAEXXXXXXXXXXXXXXX
XXXJAEXXXXXXX8JAEXXXXXXN7X2335XX
XXXJAEX1233334JAEXXXXXX8XXXXX9XX
XXXJAEXXXXXXXXJAEXN3333MXXXXX8XX
XXXJADBBBBBBBBCAENMXXXXXXXXXX8XX
XXXJAAAAAAAAAAAAE8XXXXXXXXXXX0XX
XXXXFFFFFFFFFFHAE8XXXXXXXXXXXXXX
XXXXXXXXXXXXXXJAE8XXXXXXXXXXXXXX
X3333333333335JAE8XXXXXXXXXXXXXX
XXXXXXXXXXXXX9JAE8XXXXXXXXXXXXXX
XXXXXXXXXXXXX8JAE8XXXXXXXXXXXXXX
XXXXXXXXXXXXX8JAE8XXXXXXXXXXXXXX