BBBBBBBBBBBBBBBBBBBBBBBBBBBBBBBB
AAAAAAAAAAAAAAAAAAAAAAAAAAAAAAAA
FFFFFFFFFFFFFFHAKFFFFFFFFFFFFFFF
12333333333335JAE6XXXXXXXXXXXXXX
XXXXXXXXXXXXX9JAE8XXXXXXXXXXXXXX
XXXXXXXXXXXXX8JAE8XXXXXXXXXXXXXX
XXXXXXXXXXXXX8JAE8XXXXXXXXXXXXXX
XXXXXXXXXXXXX8JAE8XXXXXXXXXXXXXX
XXXXXXXXXXXXX8JAE8XXXXXXXXXXXXXX
XXXXXXXXXXXXX8JAE8XXXXXXXXXXXXXX
XXXXXXXXXXXXX8JAE8XXXXXXXXXXXXXX
XXXXXXXXXXXXX8JAE8XXXXXXXXXXXXXX
XXXXXXXXXXXXX8JAE8XXXXXXXXXXXXXX
XXXXXXXXXXXXX8JAE8XXXXXXXXXXXXXX
XXXXXXXXXXXXX8JAE8XXXXXXXXXXXXXX
XXXXXXXXXXXXX8JAE8XXXXXXXXXXXXXX
XXXXXXXXXXXXX8JAE8XXXXXXXXXXXXXX
XXXXXXXXXXXXX8JAE8XXXXXXXXXXXXXX
XXXXXXXXXXXXX8JAE8XXXXXXXXXXXXXX
XXXXXXXXXXXXX8JAE8XXXXXXXXXXXXXX
XXXXXXXXXXXXX8JAE8XXXXXXXXXXXXXX
XXXXXXXXXXXXX8JAE8XXXXXXXXXXXXXX
XXXXXXXXXXXXX8JAE8XXXXXXXXXXXXXX
XXXXXXXXXXXXX8JAE0XXXXXXXXXXXXXX
